##############################
# / @    #          #        # 
# @@@    #  #######!#        # 
#   #    #  #       #        # 
#####    #  #       # ########
#       @@  #@@@@   #        #
#        #@@@@@@    #        #
#        #          #  ##@@@@#
#      ! #          !  @  !#@#
############################D#