##############################
# D @                  !     #
#@@@@   /     ####           #
#                      !     #
#                            #
#                            #
#    +  -  *  $              #
#                            #
#                            #
#                            #
##############################