##############################
#!        $   -             !#
#     @@@         @! @       #
#    @  -@        @@ @       #
#    @/  @ *  +   @ @@       #
#     @@@         @ D@       #
#  +        $                #
#     ###          ###       #
#                            #
#!     $     !              !#
##############################