##############################
# / @    #    *     #    $   # 
#   @    #  #######!#        # 
#   #    #  #       #    $   # 
#####    @  #  -    # ########
#       @@  #@@@@   #        #
#  +     #@@@@@@    #   -    #
#        #          #  ##@@@@#
#  $   ! #          !  @ !#@@#
############################D#