##############################
#                            #
#     @@@         @  @       #
#    @   @        @@ @       #
#    @/  @        @ @@       #
#     @@@         @ D@       #
#                            #
#     ###          ###       #
#                            #
#           !!!!!            #
##############################