##############################
# / @    #          #        # 
#   @    #  #######!#        # 
#   #    #  #       #        # 
#####    @  #       # ########
#       @@  #@@@@   #        #
#        #@@@@@@    #        #
#        #          #  ##@@@@#
#      ! #          !  @  !#@#
############################D#