##############################
# D @                  !     #
#@@@@   /                    #
#                      !     #
#            ####            #
#                            #
#                            #
#                            #
##############################