##############################
# D @                  !     #
#@@@@   /     ####           #
#                      !     #
#                            #
#                            #
#       -                    #
#                            #
#                            #
# $                   *      #
##############################